genericfont	KEYWORD1
get_max_buf_size	KEYWORD2
get_character_spacing	KEYWORD2
getcharacter	KEYWORD2
font_prop_sans_height14px_font	KEYWORD1
xy	KEYWORD1
compare	KEYWORD2
getx	KEYWORD2
gety	KEYWORD2
setx	KEYWORD2
sety	KEYWORD2
rectangle	KEYWORD1
topleftcorner	KEYWORD2
size	KEYWORD2
lies_fully_within	KEYWORD2
get_topleftcorner	KEYWORD2
get_size	KEYWORD2
get_width	KEYWORD2
get_height	KEYWORD2
get_bottomleftcorner	KEYWORD2
get_bottomrightcorner	KEYWORD2
get_toprightcorner	KEYWORD2
set_topleftcorner	KEYWORD2
set_size	KEYWORD2
set_topleft_bottomright	KEYWORD2
get_numberofpixels	KEYWORD2
ArdGrafix6100_Philips	KEYWORD1
lcd_reset	KEYWORD2
set_position_for_write	KEYWORD2
setpixel	KEYWORD2
fillrect	KEYWORD2
showbitmap	KEYWORD2
draw_rect	KEYWORD2
draw_line	KEYWORD2
draw_circle	KEYWORD2
printchars	KEYWORD2
clearscreen	KEyWORD2
